111111111111111111111111111111111111111111111111111111111111
10P000000100000000M00000010000100000000C0C0C0C00000111100001
100000000100000000000000000E00100000C000C00000M0C00000000001
1000000001000000C00000000111111C000C00111100010000000000C0C1
100000000100000000M00000000000000000000000000000000111111111
1000000001000000000M0000000000111101111111111CCC111000000001
1000000C0000000C000000000000001CC00C0M0111111000000000C00111
111111111111111111111111111111111111111111111111111111111111
