111111111111111111111111111111111111111111111111111111111111
10P000000100000000000000010000100000000C0C0C0C00000111100001
100000000100000000000000000E00100000C000C0000000C00000000001
1000000000000000C00000000111111C000C00111100010000000000C0C1
100000000100000000000000000000000000000000000000000111111111
100000000100000000000000000000100001111111100CCC000000000001
1000000C0000000C000000000000001CC000C000111111000000000C0011
1000000C0000000C000000000000001CC000C000111111000000000C0011
1000000C0000000C000000000000001CC000C000111111000000000C0011
1000000C0000000C000000000000001CC000C000111111000000000C0011
1000000C0000000C000000000000001CC000C000111111000000000C0001
111111111111111111111111111111111111111111111111111111111111
