1111111111111111111
10000000000000P1111
1CC0000000000101111
11110000111C0011111
11110000111C1111111
1111111111111111111
