1111111111111111111
10000000000000P1111
1CC0E00000000101111
11110000111C0011111
11110000111C1111C11
1111111111111111111
